NO ./texture/wll.xpm
SO ./texture/greystone.xpm
WE ./texture/mossy.xpm
EA ./texture/eagle.xpm

F 220,225,0
C 225,30,0

1111111111111111111111111
        10000000000000001
        10000000001000011
        1000000001N00001
111111111000000000000001
10000000000000000000000111111
11111111111111110000000000001
10000000000000000000000000001
10000111111111110000000000001
10000000000000000000000000001
10000000000000011111100000001
1001111111000001    100000011
10000011 1000001    100000001
11111111 1111111    111111111